,Name,Original_data,Predicted_num,Predicted_correct_num,Predicted_false_num,Accuracy
0,traffic sign,40,0,0,40,0.0
1,traffic light,51,3,3,48,0.058823529411764705
2,car,88,35,32,56,0.36363636363636365
3,rider,8,0,0,8,0.0
4,motor,5,1,1,4,0.2
5,person,39,14,11,28,0.28205128205128205
6,bus,5,4,2,3,0.4
7,truck,2,2,1,1,0.5
8,bike,6,1,1,5,0.16666666666666666
9,train,0,0,0,0,0.0
